WDDDDDDDDDDDDDDDDDDDW
WE                  WWW
W                     W
WWWH             WH   W
WWWWWWWWWWWWWWWWWWW   W
WDDDDDDDDDDDWDDDDDDW  W
W                     W
W                     W
W   HW              WWW
W   WWWWDDWDDDDWDDWWWWW
W  WDDDDDWWWWWWDDDDDW
W                   WWW
W                     W
WWW              W    W
WWWWWWWWWDDDDWWWWWW   W
WWWWDDDDWWWWWWWDDDDW  W
W                     W
W                     W
W  W               HWWW
WWWWWWWWWWWDWWWWWWWWW