WSSSSSWSWWWWWWWWWWWWW
W       VW          W
W  H     WE         W
W   WW   W          W
W    W   W          W
W    W   W         WW
WW   W   W        W W
W    W   W          W
W    W   W          W
W    W   WW         W
W   WW   W          W
W    W   W         WW
W    W   W          W
W    W   W          W
WW   W   W  V   V   W
W    W   W  W       W
W    W      W      HW
W    WV     WWWWWWWWW
WWWWWWWWWWWWWWWWWWWWW
WWWWWWWWWWWWWWWWWWWWW