WDDDDDDWWWDDWWDDDWWWW
WE                  W
W                   W
W   WWWB D W  WWW    W
W    D B D D  D      W
W    D   DWD  DD    W
W    D   D D  D     W
     D   D D  DDD
    VVVVVVVVVVVVVV
W                 D W
W   DDD DDHHD DD   BW
    DHH DDDHD DHD
    DDH DHDHD D  DB
WDDDDHH DHDDD DHD   W
W   DDD DHHDD DD    W
W                  WW
W                   W
W  WH               W
WWWWWWWWWWWWWWWWWWWWW
WWWWWWWWWWWWWWWWWWWWW