WWWWWWWWWWWWWWWWWWWWW
W                   WWW
W                     W
W                     W
W                 W   W
WE                 W  W
WDDDDDDDDDDDDDDDDDDD  W
W                     W
W                     W
W       W           WWW
W                  DW
                 D

WWWDDDDDDDDDDDDDD   W
W                  W
W                  W
W                  W
W                  W
WWWDDDDDDWWDDDDDDWWWW
WWWWWWWWWWWWWWWWWWWWW