WWWWWWWWWWWWWWWWWWWWW
W                   W
W E                 W
WWWWW               W
W                   W
W                   W
W                   W
WW                  W
W                   W
W                    W
WWWWWWWWWWWWWWWWWW   W
W                W  W
W                W  W
   WWWWWWW  WWWWWW
   W     W       W
WWWW            WWWWW
W     W       W     W
W                   W
WWWWWWWDDDDDDDWWWWWWW
WWWWWWWWWWWWWWWWWWWWW