WWWWWWWWWWWWWWWWWWWWW
W                   W
W   E               W
W                   W
W                   W
W          WWWWWWW  W
W                   W
W                   W
W               W   W
W  WWWWW            W
W                   W
W                 WWW
W                   W
W                   W
W      WWWWWW       W
W                   W
W                   W
W                   W
WWWWWWWWWWWWWWWWWWWWW
WWWWWWWWWWWWWWWWWWWWW