WWWWWWWWWWWWWWWWWWWWW
W                   W
W E                 W
W                  WW
W                   W
W                   W
WW                 WW
W                   W
W                   W
W                 WWW
W                   W
W                   W
W        W          W
W                   W
WW       W          W
W                   W
         W

WWWWWWWWWWWWWWWWWWWWW
WWWWWWWWWWWWWWWWWWWWW