WWWWWWWWWWWWWWWWWWWWW
     WE
     W           W
W    W              W
W   WW          WW  W
W    W              W
W    W           W  W
W    W              W
WW   W       WWWWW  W
W    W              W
W    W           W  W
WW   W              W
W    WW             W
W    W           W  W
W    W            W W
W   WW              W
     W
     W
WWWWWWWWWWWWWWWWWWWWW
WWWWWWWWWWWWWWWWWWWWW