WWWWWWWWWWWWWWWWWWWWW
W                   W
W                   W
W  WWDDDDD          W
W   WWWWWWDDDDD     W
W   WWWWWWWWWWWDD   W
WW  W               W
W   W               W
W   W               W
W   W             DDW
WW  W          DDDWWW
W   W       DDDWWWWWW
W   W               W
W   W               W
WW  WDDDDD          W
W   WE    DDD       W
W   W        DD     W
W   W               W
WWWWWDDDDDW         W
WWWWWWWWWWWWWWWWWWWWW